....    ::                                .................:::::::::::::::::::::
....    ::                                .................:::::::::::::::::::::
....    :::                               .................:::::::::::::::::::::
....    ::::                              ..................::::::::::::::::::::
....    ::::-                             ..................::::::::::::::::::::
....    ::::--                            ..................::::::::::::::::::::
....    ::::--                            ...................:::::::::::::::::::
....    ::::---                           ...................:::::::::::::::::::
....    ::::----                          ....................::::::::::::::::::
......   :::-----                         .....................:::::::::::::::::
......   :::-----                         ......................::::::::::::::::
......   :::----------                    .......................:::::::::::::::
......   :::------------------            ........................::::::::::::::
......   :::--------------------:::       .........................:::::::::::::
......   :::--------------------:::      ............................:::::::::::
......   :::--------------------:::       .............................:::::::::
.....    :::--------------------:::       ...............................:::::::
.....    :::--------------------:::       ..................................::::
.....    :::--------------------:::       ......................................
.....    :::--------------------:::       ......................................
....     :::-----:--------------:::        .....................................
....     :::-----:--------------:::        .....................................
....     :::-----:--------------:::        .....................................
...      :::-----:--------------:::         ....................................
...      ::::---::--------------:::         ....................................
...      ::::---::--------------:::          ...................................
..       ::::---::--------------:::          ...................................
..       ::::--:::-------.:-     ..           ..................................
.        ::::--:::........     ....             ................................
.         :::::::...      .........             ................................
          ::::::          ........              ................................
          :::::        .......                  ................................
          ::::      ......                      ................................
          ::: ........                          ................................
          ::........                            ................................
          :........      .      ...             ................................
          .........  .....  ..............      ................................
         ..............   .................     ................................
        ..........        ..................    ................................
       .......            ...................   ................................
      ...                 ....................  ................................
                          .....................  ...............................
                          ......................  ..............................
                          ....................    ..............................
                          .................        .............................